"filename", "language", "Dart", "comment", "blank", "total"
"c:\Users\onory\dev\classroom33admin\lib\extension\correct_answer.dart", "Dart", 10, 0, 2, 12
"c:\Users\onory\dev\classroom33admin\lib\extension\position_color.dart", "Dart", 28, 0, 3, 31
"c:\Users\onory\dev\classroom33admin\lib\main.dart", "Dart", 80, 1, 5, 86
"c:\Users\onory\dev\classroom33admin\lib\page\main.dart", "Dart", 39, 0, 3, 42
"c:\Users\onory\dev\classroom33admin\lib\page\user_register.dart", "Dart", 195, 3, 7, 205
"c:\Users\onory\dev\classroom33admin\lib\provider\big_question_storage.dart", "Dart", 1431, 0, 5, 1436
"c:\Users\onory\dev\classroom33admin\lib\provider\projector\timer_provider.dart", "Dart", 25, 4, 8, 37
"c:\Users\onory\dev\classroom33admin\lib\provider\state_item.dart", "Dart", 23, 0, 5, 28
"c:\Users\onory\dev\classroom33admin\lib\provider\users.dart", "Dart", 31, 0, 4, 35
"c:\Users\onory\dev\classroom33admin\lib\schema\question\big_question_item.dart", "Dart", 28, 5, 7, 40
"c:\Users\onory\dev\classroom33admin\lib\schema\question\question_category.dart", "Dart", 19, 0, 4, 23
"c:\Users\onory\dev\classroom33admin\lib\schema\question\small_question_item.dart", "Dart", 29, 6, 6, 41
"c:\Users\onory\dev\classroom33admin\lib\schema\state\state.dart", "Dart", 38, 7, 11, 56
"c:\Users\onory\dev\classroom33admin\lib\schema\user\small_question_result.dart", "Dart", 38, 3, 7, 48
"c:\Users\onory\dev\classroom33admin\lib\schema\user\user_model.dart", "Dart", 69, 10, 18, 97
"c:\Users\onory\dev\classroom33admin\lib\schema\user\user_register_model.dart", "Dart", 17, 0, 4, 21
"c:\Users\onory\dev\classroom33admin\lib\utils\colors.dart", "Dart", 0, 0, 1, 1
"c:\Users\onory\dev\classroom33admin\lib\utils\logger.dart", "Dart", 0, 0, 1, 1
"c:\Users\onory\dev\classroom33admin\lib\utils\provider_logger.dart", "Dart", 50, 3, 7, 60
"Total", "-", 2150, 42, 108, 2300